1111111111
1110111101
110000E001
1111P11111
11B0000C11
1111111111
