11111
100E1
1P001
100C1
11111
