1111111111
111C111101
11000E0001
1111P11111
1K00000C11
1111111111
