11111111111111111111111111111111111111111111111111111
1000000000100000100000000000000010000000001E100000001
1011111111101110101111111111111010111111101C101011101
10000000100010001010000000000010101000000000101010101
10111110101110111010111111111010101011111111101010101
10101111101000000010100000001010101000001000101010101
10101111101011111110101111101010101011101010101010101
10100000001010000010101000101010101010101010101010001
10111111111010111010101110101010101010101011101011111
10001000000010101010100000101010001010101000001000001
11111111111111101010111111101011111010101111111111101
10100000000000101010000010001000000010101000000000101
10101111111110101010111010111111111110101011111110101
10101000000010101010001010100000000010101000001010101
10101011111010101011101010101111111010101111101010101
10101010001010001000001010101000001010100000101010101
10101010111011111111111010101011101010111110101010101
10101010000010000000000010101010101010000010101010101
10101011111110111111111110101010101011111010101010101
10101000000010100000000000101010101000000010101000101
10101111111010101111111110101010101111111110101111101
10000000001010101000000010001010100010000000100000001
11111111101010101011111011101010111010111111101111111
10000000101010101010100000001000001010000010001000001
10111110101010101010101111111111101011111010111011101
10101010001010101010101000100000101000000010000010101
10101011101010101010101010101110101111111011111110101
10101010001010101010101010101010101000001010001000101
10101010101010101010101010101010101011101010101010101
10001010101010101000101010101010101010101010101010101
11111010101011111111101010101010101010101010101110101
10000010101010000000101010101010001010101010101010101
10111110101010111110101010101011111010101110101010101
10001010101010100000101010101000000010100000101010101
11101010101010101111101010101111111110101111101010101
10001010101000101000001010000000000000101000101010101
10101010101010101011111011111111111110101010101010101
10101000101010101010000010000000000000101010101010101
10101111101010101011111110111110111111101011101010101
10100000001010101000000010000010100000001000000010101
10111111111010101111111011111010101111111111111110101
1000000000001P100000000000000010000000000000000000001
11111111111111111111111111111111111111111111111111111
