111111111111
100E00000001
10000000P001
1C0000000001
111111111111